valor1,valor2,valor3,valor4,suma,minimo,maximo,average
45,63,90,30,228,30,90,57.0
34,43,80,89,246,34,89,61.5
22,12,70,65,169,12,70,42.25
67,34,60,43,204,34,67,51.0
89,67,34,12,202,12,89,50.5
120,86,50,34,290,34,120,72.5
23,123,60,56,262,23,123,65.5
56,25,123,78,282,25,123,70.5
23,32,245,99,399,23,245,99.75
35,128,12,11,186,11,128,46.5
